00000000000000000000
00000000000000000000
00000000000000000000
00000000844900000000
000000007HH500000000
000000007LH500000000
000000007HH500000000
00000084CHGD49000000
0000007HHHHKH5000000
0000007HHMHHH5000000
000000B666FIH5000000
0000000000B66A000000
00000000000000000000
00000000000000000000
00000000000000000000
