00000000000000000000
00000000000000000000
00000000000000000000
00000000000000000000
00844444444490000000
007HHIHHGHHH50000000
007HGIHHLHHH50000000
007HHGIIGHGGD4449000
00BFHHGGHMMHMHMH5000
000BFHHHHHHHHHHH5000
0000B66666666666A000
00000000000000000000
00000000000000000000
00000000000000000000
00000000000000000000
