00000000000000000000
00000000000000000000
00000000000000000000
00000000000000000000
00000008444490000000
00000007IIIH50000000
00000007HHMH50000000
00000007HGMG50000000
00000007HHMH50000000
00000007HHLH50000000
0000000B6666A0000000
00000000000000000000
00000000000000000000
00000000000000000000
00000000000000000000
