00000000000000000000
00000000000000000000
00000000000000000000
00000000000000000000
00000844444444900000
000007HHHHHHHH500000
000007HGGIGGGH500000
000007HGHMMHIH500000
000007HIHLMGGH500000
00000B666FHHHH500000
000000000B6666A00000
00000000000000000000
00000000000000000000
00000000000000000000
00000000000000000000
