00000000000000000000
00008444900000000000
00007HHHD49000000000
00007HGMHH5000000000
00007HMHHH5000000000
00007HMHMH5000000000
00007HMGHH5000000000
00007HHLGG5000000000
00007GHGGGD444900000
00007HHHHHHIII500000
00007HHHHHHHHH500000
0000B666666FII500000
00000000000B66A00000
00000000000000000000
00000000000000000000
