00000000000000000000
00000000000000000000
00000000000000000000
00000000000000000000
00000008449000000000
0000084CHHD444900000
000007HHMHHLII500000
000007HMHHHHGH500000
00000B6FHGGGGH500000
00000007HHHHHH500000
0000000B666666A00000
00000000000000000000
00000000000000000000
00000000000000000000
00000000000000000000
