00000000000000000000
00000000000000000000
00000000000000000000
00000000000000000000
00000084444490000000
0000007IHGHH50000000
0000007HHMHH50000000
0000007IHMGL50000000
0000007HHMHH50000000
0000007IHGHH50000000
000000B66666A0000000
00000000000000000000
00000000000000000000
00000000000000000000
00000000000000000000
