00000000000000000000
00000000000000000000
00000000000000000000
00000000000000000000
00000084490000000000
0000007HHD4490000000
0000007HIHIH50000000
0000007HMMGL50000000
000000BFHHHH50000000
0000000B6666A0000000
00000000000000000000
00000000000000000000
00000000000000000000
00000000000000000000
00000000000000000000
