00000000000000000000
00000000000000000000
00000000000000000000
00000084444490000000
0000007HHIHID4900000
0000007HIHIHIH500000
000008CGHGGGGH500000
000007HHLMHHMH500000
000007HHMMHHMH500000
00000B66FHHHE6A00000
00000000B666A0000000
00000000000000000000
00000000000000000000
00000000000000000000
00000000000000000000
