00000000000000000000
00000000000000000000
00000008449000000000
00000007HH5000000000
0000084CHH5000000000
00008CHHMH5000000000
00007HHHGH5000000000
00007HGMMHD444490000
00007HGHHHGHHHI50000
00007HHMHHLHHHI50000
0000B6FHHE66FII50000
000000B66A00B66A0000
00000000000000000000
00000000000000000000
00000000000000000000
