00000000000000000000
00000000000000000000
00000084444444900000
0000007HHHHHHH500000
000008CLGGGGGH500000
000007HHGHHHGH500000
000007HHGHHHMI500000
000007HHEFMGGI500000
000007GMDCHHGI500000
000007HHHMHHGI500000
000007HHHGHHE6A00000
00000B666666A0000000
00000000000000000000
00000000000000000000
00000000000000000000
