00000000000000000000
00000000000000000000
00000000000000000000
00000000000000000000
00000084444444900000
0000007HHHHGHH500000
000008CHMGMGHH500000
000007HHIMILHH500000
000007HHIGHHHH500000
00000B66666666A00000
00000000000000000000
00000000000000000000
00000000000000000000
00000000000000000000
00000000000000000000
