00000000000000000000
00000000000000000000
00000844908449000000
00008CHHD4CHHD900000
00007HHHGHGHHH500000
00007HHKIHIKHH500000
0000BFGMHHHMGEA00000
000007HHHLHHH5000000
00008CGMHHHMGD900000
00007HHKIHIKHH500000
00007HHHGHGHHH500000
0000BFHHE6FHHEA00000
00000B66A0B66A000000
00000000000000000000
00000000000000000000
