00000000000000000000
00000000000000000000
00000000000000000000
00000000844490000000
000000007HHH50000000
000000007HIH50000000
00000008CHKH50000000
00000007HHKG50000000
00000007HHLG50000000
0000000BFHMH50000000
000000007HHH50000000
00000000B666A0000000
00000000000000000000
00000000000000000000
00000000000000000000
