00000000000000000000
00000000000000000000
00000000000000000000
00000008444490000000
00000007HHHH50000000
00000007HGGLD9000000
0000084CHGHMH5000000
000007HIIGHMH5000000
000007HHHHHHH5000000
000007HHE6666A000000
00000B66A00000000000
00000000000000000000
00000000000000000000
00000000000000000000
00000000000000000000
