00000000000000000000
00000000000000000000
00000000000000000000
00000000000000000000
00000008444490000000
00000007HHHH50000000
00000007HGLH50000000
00000007HMKH50000000
00000007HIKH50000000
00000007HHHH50000000
0000000B6666A0000000
00000000000000000000
00000000000000000000
00000000000000000000
00000000000000000000
