00000000000000000000
00000000000000000000
00000000000000000000
00000000000000000000
00000008449000000000
00000007HHD490000000
00000007HMMH50000000
00000007IIIH50000000
00000007HLMH50000000
00000007HHHEA0000000
0000000B666A00000000
00000000000000000000
00000000000000000000
00000000000000000000
00000000000000000000
