00000000000000000000
00000000844449000000
000000007HIIL5000000
000000007HMMH5000000
00000000BFHE6A000000
0000000007H500000000
0000000007H500000000
000000844CH500000000
0000007HHHHD90000000
0000007HGHHH50000000
0000007HHHGH50000000
000000B6FHHH50000000
00000000B666A0000000
00000000000000000000
00000000000000000000
