00000000000000000000
00000000000000000000
00000000844900000000
00000008CHH500000000
00000007IHM500000000
00000007IMH500000000
00000007IMH500000000
00000007IMH500000000
00000007IHMD90000000
00000007HHHL50000000
0000000BFHHH50000000
00000000B666A0000000
00000000000000000000
00000000000000000000
00000000000000000000
