00000000000000000000
00000000000000000000
00000084449000000000
000008CHHH5000000000
000007HHHHD444900000
000007HHGIGHHH500000
000007LHGIGHMH500000
000007HHGIGHHEA00000
000007HHHHGHH5000000
00000BFHHGGMM5000000
000000BFHHHHH5000000
00000007HHE66A000000
0000000B66A000000000
00000000000000000000
00000000000000000000
