00000000000000000000
00000000000000000000
00000008449000000000
0000008CHHD444900000
0000007HHMHHLH500000
0000007HHMGHHH500000
000008CGGHGGE6A00000
000007HHGHHH50000000
000007HHHHMH50000000
000007HIIGHH50000000
000007HHIE66A0000000
000007HHEA0000000000
00000B66A00000000000
00000000000000000000
00000000000000000000
