00000000000000000000
00084490000000000000
008CHHD4490000000000
007HHHIII50000000000
007HHHIII50000000000
007HHHGHG50000000000
007HHHGLHD4490844900
00B666FHMHHHD4CHH500
0000007HHGGMHMHHH500
000008CGHHHHHMMHH500
000007HMHHGGHHHE6A00
000007HHHHE6666A0000
00000B6666A000000000
00000000000000000000
00000000000000000000
