00000000000000000000
00000000000000000000
00000000000000000000
00000008449000000000
0008444CHH5000000000
0007HHHHHMD444449000
008CHGGHIIGHHIII5000
007HMHMMGMHHLHHH5000
007HHHHHHHHE6FHH5000
00B66666FHH50B66A000
00000000B66A00000000
00000000000000000000
00000000000000000000
00000000000000000000
00000000000000000000
