00000000000000000000
00000000000000000000
00000844444490000000
000007HHHHHH50000000
000007HGGGGH50000000
000007HGIIIL50000000
000007HGGGMGD9000000
000007HGHHHHH5000000
000007HHMMHMH5000000
00000B66FHHHEA000000
000000007IE6A0000000
00000000B6A000000000
00000000000000000000
00000000000000000000
00000000000000000000
