00000000000000000000
00000000000000000000
00000000000000000000
00000084444900000000
000008CHHHH500000000
000007HHHMH500000000
000007HHMMH500000000
00000B6FHIGD44900000
0000000BFIGHLH500000
000000007IHHMH500000
000000007IHE66A00000
00000000B66A00000000
00000000000000000000
00000000000000000000
00000000000000000000
