00000000000000000000
00000000000000000000
00000000000000000000
00000000000000000000
00000084444449000000
0000007HHHHHH5000000
0000007HIKKML5000000
0000007HHHHHH5000000
000000B666FHH5000000
0000000000B66A000000
00000000000000000000
00000000000000000000
00000000000000000000
00000000000000000000
00000000000000000000
