00000000000000000000
00000000000000000000
00000000000000000000
00000000000000000000
00000000844900000000
00000008CHH500000000
0000008CLMID90000000
0000007HMMHH50000000
0000007HIHIH50000000
000000B6FHHH50000000
00000000B666A0000000
00000000000000000000
00000000000000000000
00000000000000000000
00000000000000000000
