00000000000000000000
00000000000000000000
00000000000000000000
00000000000000000000
00000084444900000000
0000007HHHI500000000
0000007HGGHD90000000
0000007HHMML50000000
0000007HGHHH50000000
0000007IHHE6A0000000
000000B666A000000000
00000000000000000000
00000000000000000000
00000000000000000000
00000000000000000000
