00000000000000000000
00000008449000000000
0000084CHHD444900000
000007HMMHGHHH500000
000007HMHIHIMMD90000
000007HIIHGIHMH50000
00008CGHGKKHIHH50000
00007HHIHKKGHGEA0000
00007HMHIGHIIH500000
0000BFMMILIHMH500000
000007HHHGHMMH500000
00000B666FHHE6A00000
000000000B66A0000000
00000000000000000000
00000000000000000000
