00000000000000000000
00000000000000000000
00000084490000000000
0000007HHD4444449000
000844CHMHMIIIII5000
0007HHHMHHHE6666A000
0007LGGGHE6A00000000
0007HHMHH50000000000
0007HMHGH50000000000
000BFHGHH50000000000
00007HHHH50000000000
0000B6666A0000000000
00000000000000000000
00000000000000000000
00000000000000000000
