00000000000000000000
00000000000000000000
00000000000000000000
00000008444490000000
0000008CHHHH50000000
0000007HHGGH50000000
0000007HGHMH50000000
0000007HHKHI50000000
000000BFHGLEA0000000
00000007HHH500000000
0000000B666A00000000
00000000000000000000
00000000000000000000
00000000000000000000
00000000000000000000
