00000000000000000000
00000000000000000000
00000000000000000000
00000000844900000000
00000084CHHD44900000
0000007HMHMIHH500000
000008CHGHHIMH500000
000007HHHGGIGEA00000
000007HHMHHIH5000000
000007HLHGHHH5000000
000007HHE6666A000000
00000B66A00000000000
00000000000000000000
00000000000000000000
00000000000000000000
