00000000000000000000
00000000000000000000
00000000000000000000
00000000000000000000
00000084490000000000
0000007HHD4490000000
0000007IKMHH50000000
0000007HIMGH50000000
000000BFHLHH50000000
00000007HHHEA0000000
0000000B666A00000000
00000000000000000000
00000000000000000000
00000000000000000000
00000000000000000000
