00000000000000000000
00000000000000000000
00000000000000000000
00000084490000000000
0000007HHD4490000000
0000007HHHHHD9000000
000008CHGGHHH5000000
000007IHIGHLMD900000
000007HHHGHMMH500000
000007HHIGHHHH500000
00000B66666666A00000
00000000000000000000
00000000000000000000
00000000000000000000
00000000000000000000
