00000000000000000000
00000000000000000000
00844444490000000000
007HHHHHH50000000000
007HMHMMHD4444449000
00B666FHLGGIHIHH5000
0000007MHHGHIHHH5000
0000007HHHGIHIHEA000
0000007MGHGGHGH50000
0000007HHHHHHHH50000
0000007HHE6FHHEA0000
0000007HH50B66A00000
000000B66A0000000000
00000000000000000000
00000000000000000000
