00000000000000000000
00000000000000000000
00000000000000000000
00000084444449000000
0000007HHHHHH5000000
0000007HMKKKH5000000
0000007HKHHKH5000000
0000007HKHHKH5000000
0000007HKKKIH5000000
0000007HHHHHL5000000
000000B666666A000000
00000000000000000000
00000000000000000000
00000000000000000000
00000000000000000000
