00000000000000000000
00000000000000000000
00000000000000000000
00000000084449000000
0000000007HHHD900000
0000000007HMHH500000
00084444GGGHGLD90000
0007HIHHGHMHMHH50000
0007HHHHHHHHMGH50000
0007IIIE666FHHH50000
000B666A000B666A0000
00000000000000000000
00000000000000000000
00000000000000000000
00000000000000000000
