00000000000000000000
00000000000000000000
00000000000000000000
00000844444490000000
000007HLHGHH50000000
000007HHHHHH50000000
00000B666FMH50000000
0000000007HHD4900000
0000000007MHII500000
0000000007HHE6A00000
000000000B66A0000000
00000000000000000000
00000000000000000000
00000000000000000000
00000000000000000000
