00000000000000000000
00000008444449000000
00000007HHHHH5000000
00000007HGHGH5000000
00000007HLHMH5000000
0000084CHGGGH5000000
000007HHHGGGH5000000
000007HMHHGGI5000000
00000BFHMHHGI5000000
000000BFHMHHI5000000
0000000BFHMGI5000000
00000000BFHGI5000000
0000000007HHH5000000
000000000B666A000000
00000000000000000000
