00000000000000000000
00000000000000000000
00000000000000000000
00000000000000000000
00000084449000000000
0000007HHHD490000000
0000007HHMHH50000000
000000BFKHIH50000000
00000007HHHL50000000
0000000B6666A0000000
00000000000000000000
00000000000000000000
00000000000000000000
00000000000000000000
00000000000000000000
