00000000000000000000
00000000000000000000
00000000000000000000
00000000000000000000
00000008444449000000
00000007HHHHH5000000
00000007HIMIH5000000
0000008CHMLMH5000000
0000007HHIMIH5000000
0000007HHHHHH5000000
000000B666666A000000
00000000000000000000
00000000000000000000
00000000000000000000
00000000000000000000
