00000000000000000000
00000000000000000000
00000000000000000000
00000000000000000000
00000084444490000000
0000007HHHHH50000000
0000007LMMMHD9000000
0000007HHGIII5000000
000000BFHHHHEA000000
0000000B6666A0000000
00000000000000000000
00000000000000000000
00000000000000000000
00000000000000000000
00000000000000000000
