00000000000000000000
00000000000000000000
00000000000000000000
00844444444449000000
007HHHHHGHHHHD900000
007IGGHHGMGGHHD90000
007HHHGHHHHHGHHD9000
007MHHGHGGGHHGHH5000
007HGHHHHHHGHHGH5000
007HGHGGGGHHGHGH5000
007IHLHHHHMHKHIH5000
00B6666666666666A000
00000000000000000000
00000000000000000000
00000000000000000000
