00000000000000000000
00000000000000000000
00000000000000000000
00000084444444900000
000084CHLHGHHH500000
00007HKHMHKIIH500000
00007HHHMHGHHH500000
0000BFGGKGHHE6A00000
000007HHHHHEA0000000
000007HHHE6A00000000
00000B666A0000000000
00000000000000000000
00000000000000000000
00000000000000000000
00000000000000000000
