00000000000000000000
00000000000000000000
00000000000000000000
00000000084490000000
000000084CHL50000000
00000007HHMH50000000
00000007HHKI50000000
00000007HHKI50000000
00000007HHMH50000000
0000000B6FHH50000000
000000000B66A0000000
00000000000000000000
00000000000000000000
00000000000000000000
00000000000000000000
