00000000000000000000
00000000000000000000
00000000000000000000
00000084444900000000
0000007HHLH500000000
0000007HHGHD90000000
0000007HIGHHD9000000
0000007HIMMMH5000000
0000007HIGHHH5000000
000000B66FHHH5000000
000000000B666A000000
00000000000000000000
00000000000000000000
00000000000000000000
00000000000000000000
