00000000000000000000
00000000000000000000
00000000000000000000
00000008444444900000
00000007HHGHIH500000
00000007HHHIKI500000
00000007HHGHKH500000
0000084CGMGGIG500000
000007HHHHHHMH500000
000007HMHGGHMH500000
000007HHHLGHHH500000
00000B66666666A00000
00000000000000000000
00000000000000000000
00000000000000000000
