00000000000000000000
00000000000000000000
00000000000000000000
00000844444900000000
000007HHHHHD49000000
000007HHLMMII5000000
00000B6FGHGGH5000000
00000007HHHHH5000000
00000007HHE66A000000
00000007HH5000000000
0000000B66A000000000
00000000000000000000
00000000000000000000
00000000000000000000
00000000000000000000
