00000000000000000000
00000000000000000000
00000000000000000000
00000000084490000000
0000000007HH50000000
0000000007LH50000000
000000844CMI50000000
0000007HHHMI50000000
0000007HGHMI50000000
0000007HHHHEA0000000
000000B6666A00000000
00000000000000000000
00000000000000000000
00000000000000000000
00000000000000000000
