00000000000000000000
00000000000000000000
00000000000000000000
00000084449000000000
0000007HHHD900000000
0000007HGHH500000000
0000007LMKID90000000
000000BFHHIH50000000
00000007HMGH50000000
0000000BFHHH50000000
00000000B666A0000000
00000000000000000000
00000000000000000000
00000000000000000000
00000000000000000000
