00000000000000000000
00000000008449000000
0000000084CHH5000000
000000007HHHH5000000
000000007HHGH5000000
000000007MHGI5000000
000000007HHGH5000000
000000007MHGI5000000
000000007HHGH5000000
00000844CMHGI5000000
000007HLHHHHH5000000
000007HHHGHHEA000000
00000B666666A0000000
00000000000000000000
00000000000000000000
