00000000000000000000
00000000000000000000
00844490000000000000
007HHHD9084490000000
007HHMHD4CHI50000000
007HMHHHMHHI50000000
007GHMGE6FGI50844900
007HMHH507HID4CHH500
007HHHH507HIGHHLH500
00B6FHH507HHHHHHH500
0000B66A0BFHHHHHEA00
0000000000B66666A000
00000000000000000000
00000000000000000000
00000000000000000000
