00000000000000000000
00000000000000000000
00000000000000000000
00000084444490000000
0000007HHHHH50000000
000008CHGGGMD9000000
000007IMHHHLH5000000
000007HIIHGMH5000000
000007IGGHHMH5000000
000007HHHHE66A000000
00000B6666A000000000
00000000000000000000
00000000000000000000
00000000000000000000
00000000000000000000
