00000000000000000000
00000000000000000000
00000000000000000000
00000008449000000000
00000007HH5000000000
00000007HHD449000000
0000084CMIMHH5000000
000007HHILIHH5000000
000007HHMIME6A000000
00000B66FHH500000000
000000007HH500000000
00000000B66A00000000
00000000000000000000
00000000000000000000
00000000000000000000
