00000000000000000000
00000000000000000000
00000000000000000000
00000084444449000000
0000007HHHIIH5000000
0000007HHLMMH5000000
000000B66FGHEA000000
0000000007HH50000000
0000000007HH50000000
0000000007HH50000000
000000000B66A0000000
00000000000000000000
00000000000000000000
00000000000000000000
00000000000000000000
