00000000000000000000
00000000000000000000
00000000000000000000
00000000084490000000
000000084CHHD9000000
0000008CHMHHH5000000
000008CHMHHGH5000000
000007HLGMMHH5000000
000007HIIHHE6A000000
000007HIIE6A00000000
00000B666A0000000000
00000000000000000000
00000000000000000000
00000000000000000000
00000000000000000000
