00000000000000000000
00000000000000000000
00000000000000000000
00000084449000000000
0000007HHHD490000000
0000007IHIHH50000000
0000007HHHGH50000000
000000BFHGHH50000000
00000007LMMH50000000
00000007HHHH50000000
00000007HHE6A0000000
0000000B66A000000000
00000000000000000000
00000000000000000000
00000000000000000000
