00000000000000000000
00000000000000000000
00000000000000000000
00000000000000000000
00000008444900000000
00000007HLH500000000
00000007III500000000
00000007MMMD90000000
00000007HHHH50000000
00000007HHHH50000000
0000000B6666A0000000
00000000000000000000
00000000000000000000
00000000000000000000
00000000000000000000
