00000000000000000000
00000000000000000000
00000000000000000000
00008449008449000000
00007HHD44CHH5000000
00007HHGHHGHH5000000
00007HHGHHHHMD900000
00007HHIHIGMHH500000
00007LHGGHGHMH500000
00007HHHIHGHHH500000
0000B666666666A00000
00000000000000000000
00000000000000000000
00000000000000000000
00000000000000000000
