00000000000000000000
00000000000000000000
00000000000000000000
00000000000000000000
00000084490000000000
0000007HHD4444900000
000008CHHHHMHH500000
000007HIGHMHHH500000
000007HIGME666A00000
000007HILH5000000000
00000B6666A000000000
00000000000000000000
00000000000000000000
00000000000000000000
00000000000000000000
