00000000000000000000
00000000000000000000
00000000000000000000
00000844900000000000
000007HHD44444900000
000007MHLGHHHI500000
00008CHGMMHHHI500000
00007HHMHHGGII500000
00007HHHGHE666A00000
0000B6FHHH5000000000
000000B666A000000000
00000000000000000000
00000000000000000000
00000000000000000000
00000000000000000000
