00000000000000000000
00000000000000000000
00000000000000000000
00000000000000000000
00000084490000000000
0000007HHD4900000000
0000007HHHHD49000000
0000007HHMKLH5000000
000000B6FHIGH5000000
000000007HHHH5000000
00000000B6666A000000
00000000000000000000
00000000000000000000
00000000000000000000
00000000000000000000
