00000000000000000000
00000000000000000000
00000000008449000000
0000844444CHH5000000
00007HMHHHHHHD900000
00007HMGGGGGHH500000
00007HHLGHHGHH500000
00007GHGGIIHHH500000
00007HHGHIIE66A00000
00007HMHHE6A00000000
00007HME6A0000000000
00007HH5000000000000
0000B66A000000000000
00000000000000000000
00000000000000000000
