00000000000000000000
00000000000000000000
00000000000000000000
00000000000000000000
00008444900844490000
00007HHHD44CIIH50000
00007HMMMHHHHHH50000
00007HHHMGHHIIH50000
0000B6FHLGHHGGH50000
0000007HHGGHHHH50000
000000B66666666A0000
00000000000000000000
00000000000000000000
00000000000000000000
00000000000000000000
