00000000000000000000
00000000000000000000
00000000000000000000
00000000000000000000
00000008449000000000
0000084CHHD449000000
000007HHHHHMH5000000
000007HGHHGMH5000000
000007HIHIGLH5000000
00000B6666666A000000
00000000000000000000
00000000000000000000
00000000000000000000
00000000000000000000
00000000000000000000
