00000000000000000000
00000000000000000000
00000084444900000000
0000007HHHHD90000000
0000007HMHMHD9000000
000000BFHMMHH5000000
00000007HGHHH5000000
00000007HGGHG5000000
00000007HHIHI5000000
00000007HLIHI5000000
00000007HHE66A000000
0000000B66A000000000
00000000000000000000
00000000000000000000
00000000000000000000
