00000000000000000000
00000000000000000000
00000844444449000000
00008CHHHGHHHD900000
00007HHHHGHHHH500000
00007HHMHGHMHH500000
00007HHHKIKHHH500000
00007GGGILIGGG500000
00007HHHKIKHHH500000
00007HHMHGHMHH500000
00007HHHHGHHHH500000
0000BFHHHGHHHEA00000
00000B6666666A000000
00000000000000000000
00000000000000000000
