00000000000000000000
00000000000000000000
00000084444900000000
0000007HHHH500000000
0000007HHHH500000000
000084CGGHH500000000
00007HHHGIGD44900000
00007HHHMLMHHH500000
0000B66FGIGHHH500000
00000007GHGGHEA00000
00000007HHHMI5000000
00000007HHHE6A000000
0000000B666A00000000
00000000000000000000
00000000000000000000
