00000000000000000000
00000000000000000000
00000000000000000000
00000000000000000000
00000008449000000000
00000007HI5000000000
00000007HHD490000000
00000007KLHH50000000
00000007HHMH50000000
00000007HHE6A0000000
0000000B66A000000000
00000000000000000000
00000000000000000000
00000000000000000000
00000000000000000000
