00000000000000000000
00000000000000000000
00000000000000000000
00000000000849000000
000008444907I5000000
000007HHHD4CI5000000
000007HHHMHGI5000000
000007HMHHMHH5000000
00000B666FLGH5000000
0000000007HHH5000000
000000000B666A000000
00000000000000000000
00000000000000000000
00000000000000000000
00000000000000000000
