00000000000000000000
00000000000000000000
00000000000000000000
00000000084449000000
000008444CHHH5000000
000007HHHHMHH5000000
000007HHMGMGL5000000
00000B6FHGHHH5000000
00000007HIIIH5000000
0000000B6FHHEA000000
0000000007HH50000000
000000000B66A0000000
00000000000000000000
00000000000000000000
00000000000000000000
