00000000000000000000
00000844449000000000
000007HHHHD449000000
000007HHHHIII5000000
000007HHHHIII5000000
00000B6FGGGHH5000000
00000007HHGHH5000000
00000007HMMHG5000000
00000007HLMHH5000000
00000007HMMHH5000000
0000000BFHMGH5000000
000000007HHHH5000000
00000000B6666A000000
00000000000000000000
00000000000000000000
