00000000000000000000
00000084449000000000
000008CHHH5000000000
00084CHHGH5000000000
0007HHHHIH5000000000
0007HHGGHGD449000000
0007HHIHIHGHHD900000
0007HHGHLHMHHHD49000
000B666FIHGHHMHH5000
0000000B66FHHMHH5000
0000000000BFHMHEA000
000000000007HHEA0000
000000000007HH500000
00000000000B66A00000
00000000000000000000
