00000000000000000000
00000000000000000000
00000000000000000000
00000008444490000000
00000007HHHH50000000
00000007HHMH50000000
0000008CGGMH50000000
000008CHMHMH50000000
000007IIIIGHD9000000
000007HHHHHLH5000000
00000BFHHGHHH5000000
000000B666666A000000
00000000000000000000
00000000000000000000
00000000000000000000
