00000000000000000000
00000000000000000000
00000000000000000000
00000000008449000000
00000000007HL5000000
00000000007HH5000000
0000084444CHI5000000
000007HHHMHHI5000000
000007HHMMGHI5000000
000007HHHHE66A000000
00000B6FHH5000000000
0000000B66A000000000
00000000000000000000
00000000000000000000
00000000000000000000
