00000000000000000000
00000000000000000000
00000084449000000000
000008CHHHD900000000
000007HHMHHD90000000
000007HMHMHHD9000000
00000B6FMGHIHD900000
00000007HGHIHH500000
0000008CHGGIHH500000
0000007HLHHIHEA00000
0000007HHHGHH5000000
000000B666666A000000
00000000000000000000
00000000000000000000
00000000000000000000
