00000000000000000000
00000000000000000000
00000084490000000000
0000007HHD4449000000
0000007HMMHMH5000000
0000007HHHHHH5000000
0000007GHGGHEA000000
0000007IIIGL50000000
0000007HGGGHD9000000
0000007HHHHHH5000000
0000007HHGHHH5000000
000000B666666A000000
00000000000000000000
00000000000000000000
00000000000000000000
