00000000000000000000
00000000000000000000
00000000000000000000
00000000000000000000
00000000000000000000
00008444444444900000
00007HHHHIGGHH500000
00007HMMLIIMMH500000
00007HHHGGIHHH500000
0000B666666666A00000
00000000000000000000
00000000000000000000
00000000000000000000
00000000000000000000
00000000000000000000
