00000000000000000000
00000000000000000000
00000000000000000000
00084444449084449000
0007HHGHHHD4CHHH5000
0007HHHHHHGGHMHH5000
0007IGHLHGGHMHHEA000
0007IGHHHGHMHHEA0000
0007IGHHHHMHHEA00000
0007IHGGHE666A000000
000BFHHHH50000000000
0000B6666A0000000000
00000000000000000000
00000000000000000000
00000000000000000000
