00000000000000000000
00000000000000000000
00000000000000000000
00008444444444900000
00007IIIIGHHHH500000
00007HHGHHHMMH500000
00007HHLHHGGHH500000
00007HHHHHGGMH500000
0000B6666FHHMH500000
0000000007HHHH500000
000000000B6666A00000
00000000000000000000
00000000000000000000
00000000000000000000
00000000000000000000
