00000000000000000000
00000000000000000000
00000000000000000000
00000000000000000000
00000084444444490000
000844CHHHHGGHH50000
0007HHMMMIIIIML50000
0007HHHHHHE6FHH50000
0007HHHE66A0B66A0000
000B666A000000000000
00000000000000000000
00000000000000000000
00000000000000000000
00000000000000000000
00000000000000000000
