00000000000000000000
00000084490000000000
000008CHHD4900000000
000007LMHHH500000000
00000BFGHMH500000000
0000007HHGGD44900000
0000007HHMIIII500000
0000007HHGHE66A00000
0000007GHGH500000000
0000007HMGH500000000
0000007HHHH500000000
0000007HHE6A00000000
000000B66A0000000000
00000000000000000000
00000000000000000000
