00000000000000000000
00000000000000000000
00000000000084490000
000084444444CHH50000
00007HHHGGHMHHH50000
00007HHMHHHGGHH50000
0000B6FHGIHIGHG50000
0000007HGIHIGMG50000
0000007HGHHHGHH50000
0000007HLHMHHHH50000
0000007HHE66666A0000
000000B66A0000000000
00000000000000000000
00000000000000000000
00000000000000000000
