00000000000000000000
00000000000000000000
00000084449000000000
0000007HLHD449000000
0000007HHHHHH5000000
0000007HMHMMH5000000
0000007GMGGHH5000000
0000007HHHGGEA000000
0000007HIIHH50000000
000000BFIIHH50000000
0000000B6FHH50000000
000000000B66A0000000
00000000000000000000
00000000000000000000
00000000000000000000
