00000000000000000000
00000000000000000000
00000000000000000000
00000844490000000000
000007HHHD4490000000
000007HGHGHI50000000
000007HHHHMHD4900000
000007GGHGMIHH500000
000007HHHGLHHH500000
000007HGHE6666A00000
000007HHH50000000000
00000B666A0000000000
00000000000000000000
00000000000000000000
00000000000000000000
