00000000000000000000
00000000000000000000
00000000000000000000
00000084444490000000
000008CHHIHHD9000000
000007HIMMMIH5000000
000007HMIHIMH5000000
000007IMHLHMI5000000
000007HMIHIMH5000000
000007HIMMMIH5000000
00000BFHHIHHEA000000
000000B66666A0000000
00000000000000000000
00000000000000000000
00000000000000000000
