00000000000000000000
00000000000000000000
00000000000000000000
00000000000000000000
00000000008444900000
0000000084CHHH500000
00000844CIIIII500000
000007HLMMMMMH500000
000007HHHHHGHEA00000
00000B666FHHH5000000
000000000B666A000000
00000000000000000000
00000000000000000000
00000000000000000000
00000000000000000000
