00000000000000000000
00000000000000000000
00000844908449000000
000007HHD4CHHD900000
000007HHHHHHLH500000
00008CIIGGGHHH500000
00007HHHHHHGHH500000
00007IIIGMHHGH500000
00007HGGHMMHMH500000
00007HHMHHHHE6A00000
0000B66FHHE6A0000000
0000000B66A000000000
00000000000000000000
00000000000000000000
00000000000000000000
