00000000000000000000
00000000000000000000
00000000000000000000
00000000000000000000
00000008444900000000
0000008CIHID90000000
0000007HKHKH50000000
0000007HHGHH50000000
0000007HMHMH50000000
000000BFHLHEA0000000
0000000B666A00000000
00000000000000000000
00000000000000000000
00000000000000000000
00000000000000000000
