00000000000000000000
00000000000000000000
00000000000844490000
00008444444CHHH50000
00007IHHHIHHLGI50000
00007HHGGGHHHHH50000
0000BFHMHHGHHHH50000
000007HMHHHE666A0000
000007HMGHH500000000
00000BFHGHH500000000
0000007HHHEA00000000
000000B666A000000000
00000000000000000000
00000000000000000000
00000000000000000000
