00000000000000000000
00000000000000000000
00000000000000000000
00000000844490000000
00008444CHHHD4490000
00007HHHHHGHHHH50000
00007HHGIIIIIHH50000
0000BFHHGGHGHE6A0000
000007MMLMMMH5000000
000007HHHHHE6A000000
00000B66666A00000000
00000000000000000000
00000000000000000000
00000000000000000000
00000000000000000000
