00000000000000000000
00000000000000000000
00008449000000000000
00007HH5000084449000
00007HH500007HHH5000
00007HHD4444CIGH5000
0084CGHHMHHHHIHH5000
007HHHMMGHE6FIGH5000
007HHHGHHH507HHH5000
00B6666666A07LHEA000
0000000000007HH50000
000000000000B66A0000
00000000000000000000
00000000000000000000
00000000000000000000
