00000000000000000000
00000000000000000000
00000000000000000000
00000000000000000000
00000844444444490000
00008CIIIIIIIHH50000
00007HMMMMMMMLH50000
00007HHHGHGHGHEA0000
00007HGHGHHHHH500000
00007HHHE66666A00000
0000B666A00000000000
00000000000000000000
00000000000000000000
00000000000000000000
00000000000000000000
