00000000000000000000
00000000000000000000
00000000000000000000
00000000844490000000
000000007HIHD9000000
00000084CHMHH5000000
0000007HIHMGL5000000
0000007HGMHIH5000000
0000007HHMHE6A000000
000000BFHIH500000000
0000000B666A00000000
00000000000000000000
00000000000000000000
00000000000000000000
00000000000000000000
