00000000000000000000
00000000000000000000
00000084490000000000
000084CHH50000000000
00007HHHHD4900000000
00007HGHIHI500000000
00007HLHIIID44900000
00007HGHGHGHHHD90000
00007HHHGHMMHHH50000
0000B666FHHMHMH50000
00000000BFMHGHEA0000
0000000007HHHH500000
000000000B6666A00000
00000000000000000000
00000000000000000000
