00000000000000000000
00000000000000000000
00000000000000000000
00000000000000000000
00000084444490000000
0000007HHHHH50000000
0000007HGHGH50000000
0000007IHMKL50000000
0000007HHHE6A0000000
000000B666A000000000
00000000000000000000
00000000000000000000
00000000000000000000
00000000000000000000
00000000000000000000
