00000000000000000000
00000000000000000000
00000000008449000000
0000084444CHH5000000
000007HHHHHHH5000000
000007HHIIIHI5000000
000007GMGGE66A000000
000007HMHH5000000000
000007HHHMD490000000
00000BFHHMHH50000000
000000BFHLHH50000000
0000000B6666A0000000
00000000000000000000
00000000000000000000
00000000000000000000
