00000000000000000000
00000000000000000000
00000084444900000000
0000007HLHH500000000
0000007HMGH500000000
0000007HMHH500000000
0000007HMHG500000000
000000BFGHGD49000000
00000007HHGHH5000000
00000007IIIHH5000000
00000007HHHHH5000000
0000000B66666A000000
00000000000000000000
00000000000000000000
00000000000000000000
