00000000000000000000
00000000000000000000
00000000000000000000
00000000000000000000
00000008444900000000
00000007HHH500000000
0000008CHHHD90000000
0000007HMMMH50000000
0000007HIIIL50000000
000000B66666A0000000
00000000000000000000
00000000000000000000
00000000000000000000
00000000000000000000
00000000000000000000
