00000000000000000000
00000000000000000000
00000000000000000000
00000844444444900000
000007HHHGGHHH500000
000007HMHHMLGH500000
00000B66FHGHMH500000
000000007IGHHEA00000
000000007IGHM5000000
000000007IHHH5000000
000000007IHHH5000000
00000000B6666A000000
00000000000000000000
00000000000000000000
00000000000000000000
