00000000000000000000
00000844490000000000
000007HHH50000000000
000007HGHD4444490000
000007HHKHHGHHH50000
000007GHGGHHHGH50000
000007HHHHHGKHH50000
00084CHGHGHGHE6A0000
0007HHKGMILHH5000000
0007HGHHHGGHG5000000
0007HHHGHHKHH5000000
000B66666FHGH5000000
0000000007HHH5000000
000000000B666A000000
00000000000000000000
