00000000000000000000
00000000000000000000
00000000000000000000
00000084444449000000
0000007LHHHHH5000000
0000007HIMMIH5000000
0000007HMIIMH5000000
0000007HMIIMH5000000
0000007HIMMIH5000000
0000007HHHHHH5000000
000000B666666A000000
00000000000000000000
00000000000000000000
00000000000000000000
00000000000000000000
