00000844900000000000
000007HHD44900000000
000007HMHHH500000000
000007HIGHH500000000
000007HMGHEA00000000
000007HIHH5000000000
00000B66FH5000000000
000000007H5000000000
00000084CHD490000000
0000007HHMHH50000000
000008CHGMGHD9000000
000007HMHLHMH5000000
000007HIIGIIH5000000
00000B6FHHHE6A000000
0000000B666A00000000
