00000000000000000000
00000000000000000000
00000000000000000000
00000844490000000000
000007HHHD9000000000
000007HMHH5000000000
00000BFHMHD449000000
000000BFGLIHH5000000
00000007HHIGH5000000
00000007HHHHH5000000
0000000B66666A000000
00000000000000000000
00000000000000000000
00000000000000000000
00000000000000000000
