00000000000000000000
00000000000000000000
00000000000000000000
00000844444900000000
00008CHHHHHD90000000
00007HHMHMHH50000000
00007HMHMHMH50000000
0000BFHGGGHGD4900000
000007LHHIIIII500000
00000BFHHHHHE6A00000
000000B66666A0000000
00000000000000000000
00000000000000000000
00000000000000000000
00000000000000000000
