00000000000000000000
00000000000000000000
00000000000000000000
00000084449000000000
0000007HHHD490000000
0000007HIHHHD9000000
0000007GKGMHH5000000
0000007HIGHMH5000000
0000007HLGGHEA000000
0000007HHHHH50000000
000000B66666A0000000
00000000000000000000
00000000000000000000
00000000000000000000
00000000000000000000
