00000000000000000000
00000000000000000000
00000000000000000000
00000000000000000000
00008444449000000000
00007HHHHHD444900000
00007HMMGLGGII500000
00007HGHHHHHHH500000
00007HHMHGHGHH500000
0000B66FHMHHII500000
0000000B666666A00000
00000000000000000000
00000000000000000000
00000000000000000000
00000000000000000000
