00000000000000000000
00000000000000000000
00000000000000000000
00000000000000000000
00000084444490000000
000084CHHHHH50000000
00007HMHMHHH50000000
00007HGGGHGGD4900000
00007HLHIHIHHH500000
00007HHHE6FHHH500000
0000B666A0B666A00000
00000000000000000000
00000000000000000000
00000000000000000000
00000000000000000000
