00000000000000000000
00000000000000000000
00000000000000000000
00000000000000000000
00000084449000000000
0000007HHH5000000000
0000007HLH5000000000
0000007HMMD490000000
000000BFIHIH50000000
00000007HHHH50000000
0000000B6666A0000000
00000000000000000000
00000000000000000000
00000000000000000000
00000000000000000000
