00000000000000000000
00000000000000000000
00000000000000000000
00084444444444449000
0007HHHHHHGHHHHH5000
0007HMLMMHGHIHII5000
000BFHGGHGGGHGGH5000
00007HGHHHHHHHGH5000
00007HGHHHGHHHGH5000
00007HGGGGGGGGGH5000
00007HHHHHHHHHHH5000
0000B66666666666A000
00000000000000000000
00000000000000000000
00000000000000000000
