00000000000000000000
00000000000000000000
00000000000000000000
00000084444490000000
0000007HHHHH50000000
0000007HIMIH50000000
0000007HMIMH50000000
0000007HIMIH50000000
0000007HMIMH50000000
0000007HHLHH50000000
000000B66666A0000000
00000000000000000000
00000000000000000000
00000000000000000000
00000000000000000000
