00000000000000000000
00000000000000000000
00000000000000000000
00000000084449000000
0000000007HHHD900000
0000000007HHHH500000
000008444CGHHH500000
00008CHHHHHGIH500000
00007HMHMHLHHEA00000
00007HGGGGGGI5000000
00007HHHHHHHH5000000
0000B66666666A000000
00000000000000000000
00000000000000000000
00000000000000000000
