00000000000000000000
00000000000000000000
00000000000000000000
00000000000000000000
00000008444900000000
00000007IHHD90000000
00000007LMMH50000000
0000000BFHHH50000000
00000000BFHH50000000
000000000BFI50000000
0000000000B6A0000000
00000000000000000000
00000000000000000000
00000000000000000000
00000000000000000000
