00000000000000000000
00000000000000000000
00000000000000000000
00000000008444490000
00000000007HHHH50000
0000008444CHIHH50000
000084CHHGGGIHH50000
00007HMHHMHHIHEA0000
00007HLMMHGHIH500000
0000BFHHHHE666A00000
00000B6666A000000000
00000000000000000000
00000000000000000000
00000000000000000000
00000000000000000000
