00000000000000000000
00000000000000000000
00000000000000000000
00084444444449000000
0007HHHHHGHHHD490000
0007HMLMHGHIHHI50000
0007HGGHGGGHGGH50000
0007HGHHHHHHHGH50000
0007HGHHHGHHHGH50000
0007HGGGGGGGGGH50000
0007HHHHHHHHHHH50000
000B66666666666A0000
00000000000000000000
00000000000000000000
00000000000000000000
