00000000000000000000
00000084449000000000
000008CHHHD449000000
000007HHMMMHH5000000
000007HGHHHMH5000000
000007HHHMGGHD900000
00000B6FHHGIHH500000
00000007HHGHHH500000
0000008CGGGHGEA00000
0000007HHHGHG5000000
0000007HLIIII5000000
0000007HHHHHH5000000
0000007HHHGHH5000000
000000B666666A000000
00000000000000000000
