00000000000000000000
00000000000000000000
00000000000000000000
00000000000000000000
00008444490844490000
00007HHHHD4CHHH50000
00007HMMHHHHHGL50000
00007HMHGIIIHHH50000
00007HHHE666666A0000
0000B666A00000000000
00000000000000000000
00000000000000000000
00000000000000000000
00000000000000000000
00000000000000000000
