00000000000000000000
00000000000000000000
00000000000000000000
00000084444444900000
000084CHHHGHHH500000
00007HKHMHIHIH500000
00007HHHMHGGHEA00000
0000BFGGKGHHH5000000
000007HHLHHE6A000000
000007HHHE6A00000000
00000B666A0000000000
00000000000000000000
00000000000000000000
00000000000000000000
00000000000000000000
