00000000000000000000
00000000000000000000
00000000000000000000
00000084490000000000
0000007IHD9000000000
0000007ILH5000000000
0000007IHM5000000000
000000BFMHD490000000
00000007HMHH50000000
00000007HHHH50000000
00000007HHE6A0000000
0000000B66A000000000
00000000000000000000
00000000000000000000
00000000000000000000
