00000000000000000000
00000000000000000000
00008444444900000000
00007HHIIIH500000000
00007HHGGGHD90000000
00007HHGHMHH50000000
0000BFHGLMHH50000000
000007HGHMHH50000000
000007HGGGHGD4490000
000007HHHHHHHHH50000
000007HHHE6FHHH50000
00000B666A0B666A0000
00000000000000000000
00000000000000000000
00000000000000000000
