00000000000000000000
00000000000000000000
00000000000000000000
00000084444449000000
0000007HHHHHH5000000
0000007LHHHMH5000000
000008CHGGGMH5000000
000007HIIIIIGD900000
000007HMHMHMHH500000
00000B6666FHGH500000
00000000007HHH500000
0000000000B666A00000
00000000000000000000
00000000000000000000
00000000000000000000
