00000000000000000000
00000000000000000000
00000008444490000000
00000007HHHHD9000000
0000008CHGGHH5000000
0000007HMMHGH5000000
0000007HLMHGH5000000
0000007HHHHGH5000000
000008CGGHGHH5000000
000007HHIIIHEA000000
000007HHHHHEA0000000
00000B66666A00000000
00000000000000000000
00000000000000000000
00000000000000000000
