00000000000000000000
00000000000000000000
00000000000000000000
00000084444490000000
0000007HHHHH50000000
0000007IHIHH50000000
0000007HGGHEA0000000
0000007HHMH500000000
000000B6FMH500000000
000000007LH500000000
000000007HH500000000
00000000B66A00000000
00000000000000000000
00000000000000000000
00000000000000000000
