00000000000000000000
00000000000000000000
00000000000000000000
00000000000000000000
00000084444490000000
0000007HHKHH50000000
0000007HHHHH50000000
000000BFHGHEA0000000
00000007MLI500000000
00000007HHH500000000
0000000B666A00000000
00000000000000000000
00000000000000000000
00000000000000000000
00000000000000000000
