00000000000000000000
00000000000000000000
00000000000000000000
00084444444444900000
0007HHHHHHHHHH500000
0007HGGGGGGGHLD90000
0007HGHHHHHHHHH50000
0007HGHHMHHHGHH50000
0007HMMHE6FGGHH50000
000B6FHH507HIII50000
00000B66A07HHHH50000
0000000000B6666A0000
00000000000000000000
00000000000000000000
00000000000000000000
