00000000000000000000
00000000000000000000
00084444444444490000
0007IGHLGHHGHHH50000
0007IGMMHHHGHMH50000
0007IGHHGHMGHHH50000
0007IGHMGHHGHMEA0000
0007IGHHGHMGHH500000
0007IGHMGHHGHM500000
0007IIHHGHMHHH500000
0007IIHHGHHGHH500000
000B6666666666A00000
00000000000000000000
00000000000000000000
00000000000000000000
