00000000000000000000
00000000000000000000
00000000000000000000
00000000008444900000
00000000007IHH500000
00000000007IGH500000
0000844444CIGH500000
00007HLHMHMHMH500000
00007HGHGHGHE6A00000
00007HHHHHHH50000000
0000B6666666A0000000
00000000000000000000
00000000000000000000
00000000000000000000
00000000000000000000
