00000000849000000000
000000007L5000000000
00000084CMD490000000
000008CHHIHHD9000000
000007HHGHGHH5000000
000007HGHHHGH5000000
000007HGHHHGH5000000
000007HGHHHGH5000000
000007HHGHGHH5000000
00000BFHMHMHEA000000
000000BFIHIEA0000000
00000007HHH500000000
00000007HHH500000000
0000000B666A00000000
00000000000000000000
