00000000000000000000
00000000000000000000
00000008444900000000
00000007HLH500000000
0000008CHHHD90000000
000084CIMMMID4900000
00007HHMIIIMHH500000
00007HHMIGIMHH500000
00007HHMIIIMHH500000
0000B6FIMMMIE6A00000
000000BFHHHEA0000000
00000007HHH500000000
0000000B666A00000000
00000000000000000000
00000000000000000000
