00000000000000000000
00000000000000000000
00000844900000000000
000007HHD44444900000
000007HHIHGGHI500000
000007HMGHHHHI500000
00000BFHGGHGHI500000
0000007HHHHGHH500000
000000BFGGHGHH500000
00000007HLMHE6A00000
00000007HMMH50000000
00000007HHHH50000000
0000000B6666A0000000
00000000000000000000
00000000000000000000
