00000000000000000000
00000000000000000000
00000000000000000000
00000000000000000000
00008444444449000000
00007HLHIIIIH5000000
00007HHHGGGGMD900000
0000BFHGHHMHMH500000
000007HMHHHHHH500000
000007HHHE6666A00000
00000B666A0000000000
00000000000000000000
00000000000000000000
00000000000000000000
00000000000000000000
