00000000000000000000
00000000000000000000
00000000008449000000
0000000008CHHD490000
0008449007HHMHH50000
0007HHD44CHMHMH50000
0007HHHIIGHGMHH50000
0007HHGHHHLHHE6A0000
000BFHGIIGHE6A000000
00007HGGHGH500000000
00007HHHHHH500000000
0000B666666A00000000
00000000000000000000
00000000000000000000
00000000000000000000
