00000000000000000000
00000000000000000000
00000000000000000000
00000000000000000000
00000008449000000000
0000008CHHD490000000
0000007HHHHH50000000
0000007IKKML50000000
0000007HHHE6A0000000
000000BFHH5000000000
0000000B66A000000000
00000000000000000000
00000000000000000000
00000000000000000000
00000000000000000000
