00000000000000000000
00000000000000000000
00000000000844900000
00000844444CHH500000
000007HMHHHHHH500000
000007HHHMHMHH500000
000007HGGGGGE6A00000
00008CHGHIHH50000000
00007HHGHGHH50000000
00007HHLHIHEA0000000
0000BFHGHGH500000000
000007HHHIH500000000
00000B66666A00000000
00000000000000000000
00000000000000000000
