00000000000000000000
00000000000000000000
00000000000000000000
00000000000000000000
00000084444449000000
0000007HHLHHH5000000
0000007HMHHMH5000000
000008CGHGGHGD900000
000007HHMIIMHH500000
000007HHHIIHHH500000
00000B66666666A00000
00000000000000000000
00000000000000000000
00000000000000000000
00000000000000000000
