00000000000000000000
00000000000000000000
00000084449000000000
0000007HHH5000000000
0000007HIH5000000000
0000007ILID490000000
0000007GIGHH50000000
0000007HHMHH50000000
0000007HMHHH50000000
000000BFMMHH50000000
00000007HHE6A0000000
00000007HH5000000000
0000000B66A000000000
00000000000000000000
00000000000000000000
