00000000000000000000
00000000000000000000
00000000000000000000
00000000000000000000
84449000844900000000
7HHHD444CHI500000000
7HHHHHHHMHHD44444490
B6FHHE66FHIMHHHHLH50
007HH5007HHE66FHHH50
00B66A00B66A00B666A0
00000000000000000000
00000000000000000000
00000000000000000000
00000000000000000000
00000000000000000000
