00000000000000000000
00000000000000000000
00000000000000000000
00000084444490000000
0000007HLGHH50000000
0000007IMHHH50000000
0000007IHGHMD9000000
0000007IMGHHH5000000
0000007IHGHMH5000000
0000007HHGHHH5000000
000000B666666A000000
00000000000000000000
00000000000000000000
00000000000000000000
00000000000000000000
