00000000000000000000
00000000000000000000
00000000000000000000
00008444490000000000
00007HHHHD4900000000
00007HHGHMH500000000
00007HHMHLH500000000
00007GHGGHGD44900000
00007HHGIIIIII500000
00007HMHMHMHMH500000
0000BFHHHE6666A00000
00000B666A0000000000
00000000000000000000
00000000000000000000
00000000000000000000
