00000000000000000000
00000000000000000000
00000000000000000000
00000000000000000000
00000008449000000000
00000007HHD490000000
00000007HMMH50000000
0000008CIIIH50000000
0000007HHLMH50000000
0000007HHHE6A0000000
000000B666A000000000
00000000000000000000
00000000000000000000
00000000000000000000
00000000000000000000
