00000000000000000000
00000000000000000000
00000000000000000000
00000844900000000000
000007HLD49000000000
000007IKHHD444900000
000007IIGMMHMH500000
00000BFHHHHHHH500000
0000007HGHGGHH500000
0000007HHHE666A00000
000000B666A000000000
00000000000000000000
00000000000000000000
00000000000000000000
00000000000000000000
