00000000000000000000
00000000000000000000
00000000000000000000
00000844444449000000
000007HLHGHHH5000000
000007HMHMHHH5000000
000007GMGGGHG5000000
000007HHIIIHH5000000
000007HHHGHHH5000000
00000B6666FHH5000000
0000000000B66A000000
00000000000000000000
00000000000000000000
00000000000000000000
00000000000000000000
