00000000000000000000
00000000000000000000
00000000000000000000
00000000000000000000
00000000000000000000
00844900000000000000
007HHD44444444449000
007HMHMHMHMHMHLH5000
007HIIIIIHHHHHHH5000
00B6666666666666A000
00000000000000000000
00000000000000000000
00000000000000000000
00000000000000000000
00000000000000000000
