00000000000000000000
00000000000000000000
00000000000000000000
00000008449000000000
00000007HH5000000000
00000007HMD449000000
0000084CIHIHH5000000
000007HMHGHMH5000000
000007HHIHIE6A000000
00000B66FMH500000000
000000007HL500000000
00000000B66A00000000
00000000000000000000
00000000000000000000
00000000000000000000
