00000000000000000000
00000000000000000000
00000844449000000000
000007HIHH5000000000
00008CMIGH5000000000
00007HHKHH5000000000
00007HIIGG5000000000
00007GMHGHD444900000
00007GHGGHGHHH500000
00007HHGGGGHGH500000
00007HHHLHMHMH500000
0000BFHHGHHHHH500000
00000B66666666A00000
00000000000000000000
00000000000000000000
