00000000000000000000
00000000000000000000
00000000000000000000
00000000844490000000
000000007HLH50000000
000000007HHH50000000
00000008CGMH50000000
00000007HIII50000000
00000007HMMH50000000
0000000B6FHH50000000
000000000B66A0000000
00000000000000000000
00000000000000000000
00000000000000000000
00000000000000000000
