00000000000000000000
00000000000000000000
00000000000000000000
00000000000000000000
00000000008490000000
0000084444CLD9000000
000007HHHHIKH5000000
000007HHHGHHH5000000
00000B666FMGH5000000
0000000007HHH5000000
000000000B666A000000
00000000000000000000
00000000000000000000
00000000000000000000
00000000000000000000
