00000000000000000000
00000000000000000000
00000000000000000000
00844900000844490000
007HHD490007HHHD9000
007HHHH50007MHMH5000
007IIGHD444CHGHH5000
007HHLHHHHGHMHMH5000
007IIGHHHHHHHHHEA000
00BFHHHE6666666A0000
000B666A000000000000
00000000000000000000
00000000000000000000
00000000000000000000
00000000000000000000
