00000000000000000000
00000000000000000000
00000000000000000000
00000000000000000000
00000084444490000000
000008CHIIIID9000000
000007HHHGGGGD900000
000007HHHMHMHL500000
00000B6FHHMHMH500000
0000000B6FHHHH500000
000000000B6666A00000
00000000000000000000
00000000000000000000
00000000000000000000
00000000000000000000
