00000000000000000000
00000000000000000000
00000000000000000000
00000000000000000000
00000000844490000000
000000007HHH50000000
00000084CMML50000000
0000007HHHGG50000000
0000007HHHHH50000000
0000007HIHIH50000000
000000B66666A0000000
00000000000000000000
00000000000000000000
00000000000000000000
00000000000000000000
